7 7
1
#######
#.___.#
#__$__#
#_$_$_#
#__$__#
#+___.#
#######
