7 7
1
#######
#_.___#
#__$_.#
#_$_$_#
#._$__#
#_@_._#
#######
