10 7
0
     #####
######_._#
#___##$._#
#@$$$__._#
##__#__._#
 #__######
 ####
