9 9
easy4
#########
#___#___#
#_._$_._#
#___#___#
##$###$##
#___#___#
#_+_$_._#
#___#___#
#########