9 14
medium1
#####
#_@_#
#_$_#
#___#
##_##
 #_# ####
##_##___#
#.______#
#__######
##_#
#__#
#__#
#__#
####
