13 13
medium1
#############
#._________.#
#___________#
#__###$###__#
#__#_____#__#
#__#_____#__#
#@_$__#__$__#
#__#_____#__#
#__#_____#__#
#__###$###__#
#___________#
#._________.#
#############