9 14
easy5
#####
#_@_#
#_$_#
#___#
##_##
 #_#
##_######
#______.#
#__######
##_#
#__#
#__#
#__#
####
