7 7
easy2
#######
#_.___#
#__$_.#
#_$_$_#
#._$__#
#@__._#
#######
