7 10
easy3
#######
#_____#
#_$.$_#
#_____#
###_###
###_###
#_____#
#__$__#
#._@_.#
#######
