7 7
winner
 ######
 #____#
 #_*$_#
##.@.##
#_$*_#
#____#
######
