9 9
medium2
  ######
  #..._#
  ###__#
    #_###
#####___#
#@$_____#
#_$$##__#
#___#####
#####