10 7
hard1
     #####
######_._#
#___##$._#
#@$$$__._#
##__#__._#
 #__######
 ####
