8 6
medium3
   #####
####__.#
#_$_$_*#
#_@$_$.#
##_##..#
 #######