7 8
medium5
#####
#___###
#_$.._#
#_$.._#
#_$$._#
###_$#
  #_@#
  ####