8 8
medium4
   #####
 ###___#
 #___#$#
##_##__#
#_$____#
#@_##$_#
####...#
   #####
